###############
#........#A##O#
#.##.###.#.##.#
#.##.#.#.#....#
#....#..@.....#
#....#...###.A#
#.##...#.###..#
#..#..##.###..#
#A##.A........#
###############