###################
#A#.O..........*#A#
#.#######.#######.#
#...........|.....#
#.#.#####.#####.#.#
#.#.....#.#.....#.#
#.#####.###.#####.#
#.%.#.........#O..#
#######.#.#.#######
 .......#@#....... 
#######.#.#.#######
#.O*#.........#...#
#.#####.###.#####.#
#.#.....#&#.....#.#
#.#.#####.#####.#.#
#....|............#
#.#######.#######.#
#A#&...........%#A#
###################