###################
#.....#O...&#%...*#
#.#######.#######.#
#*.|..............#
#####.#######.#####
#.................#
#.#######A#######.#
#...........%.....#
#.#######.#######.#
 .#.&..........O#. 
#.#######.#######.#
#.................#
#A#######A#######.#
#..............|.A#
#####.#######.#####
#.................#
#.#######A#######.#
#...O.#..@..#.%...#
###################