###################
#..&#@............#
#.#.###########.#.#
#.#....|........#.#
#.#.#.###%#####.#.#
#.#.#*..###.....#.#
#.#.###.....#####.#
#.#.#.........#..*#
#.#.#.###.#####.###
 .#.....#O#A%...#. 
###.#####.###.#.#.#
#A..#.........#.#.#
#.#####.###.###.#.#
#.#.....#O#...#.#.#
#*#.#####.###.#.#.#
#&#..........A|.#.#
#.#.###########.#.#
#..A..........#...#
###################